I Talk to the Wind	King Crimson	9
Blue Orchid	The White Stripes	9
Sunday Best	Washington	9
If You Wanna	The Vaccines	9
The Final Blast	dEUS	9
Cochise	Audioslave	9
Wish You Well	Bernard Fanning	9
Sultans of Swing	Dire Straits	8
Doubt	Delphic	8
Come Together	Pnau	8
I Want To Know What Love Is	Foreigner	8
Fear Of The Dark	Iron Maiden	8
Bees	Warpaint	8
Can You Feel It	The Jacksons	8
Razorblade	The Strokes	8
Wreckin' Bar (Ra Ra Ra)	The Vaccines	8
Here Comes Your Man	Pixies	8
Nothing Left To Lose	Mat Kearney	8
Heart In A Cage	The Strokes	8
Sweeter Than Sugar	Joe	8
That's My Bitch	The Throne	8
Not Over	Bag Raiders	8
Hold My Breath	Holy Ghost!	8
Por Amarte Asi	Banda XXI	8
I Would Do Anything For You	Foster The People	8
In Da Club	50 Cent	8
Astair	Matt Costa	8
Hang Me Up to Dry	Cold War Kids	8
Rosario De Santa Fe	Soledad	8
Purple Haze	Jimi Hendrix	8
Que grande te queda	La Mona Jimenez	8
Out Of Dreams	The Rascals	8
Around the World	Red Hot Chili Peppers	8
Drops Of Jupiter	Train	8
Unwell	Matchbox Twenty	8
