! (The Song Formerly Known As)	Regurgitator
(Another Song) All Over Again	Justin Timberlake
(Let's Go) All The Way	The Whispers
(You Can't Blame It On) Anybody	Phoenix
1517	The Whitest Boy Alive
1901 (sayCet Remix)	Phoenix
1901 (What Kind Of Breeze Do You Blow? A-Mix)	Phoenix
1901 (What Kind Of Breeze Do You Blow? E-Mix)	Phoenix
1901	Phoenix
1999	Prince
24-25	Kings Of Convenience
24	Jem
3 Days Ago	Mario Winans
30 Minute Boyfriend	Julian Casablancas
5 Years from Now	Lil' Bran/Mike Jones
[Untitled Hidden Track]	Jamiroquai
A 1000 miles	Michelle Branch
A Beautiful Mess	Jason Mraz
A Cause Des Garcons	Yelle
A Change Is Gonna Come	Seal
A Day in the Life	The Beatles
A Game	Talib Kweli
A Hard Day's Night	The Beatles
A New Sky	The Presets	aah-01
Able Mable	Molly Wagger
Above You	The Whitest Boy Alive
Across the Universe	The Beatles
Addiction	Kanye West
Adios amor	Sabroso
Adrift	Jack Johnson
Aeons	The Presets
Affirmation	José Feliciano
Africa	Toto
After The Moment	Craft Spells
Afterglow	INXS
Again	Lenny Kravitz
Ahi controlo yo	La Konga
Ahora (f. Angel Doze)	Zion y Lennox
Ain't No Sunshine When She's Gone 	Tom Jones
Alive	Armand Margjeka
All at Once	Jack Johnson
All Ears	The Whitest Boy Alive
All Falls Down (feat. Syleena	Kanye West
All Mine	Little Red
All my friends are getting married	Skyhooks
All My Loving	The Beatles
All Night Long	Lionel Richie
All Nightmare Long	Metallica
All Of My Life	Phil Collins
All of Us (Beat Connection Remix)	Painted Palms
All Over Again	Ronan Keating
All the Right Friends	R.E.M.
All the Way to Reno	R.E.M.
All These Things That I've Done	The Killers
All You Need Is Love	The Beatles
Alley Cats	Hot Chip
Alone, Together	The Strokes
Alphabetical	Phoenix
Already Know (Interlude)	Mario Winans
Alright	Jamiroquai
Alter Ego	Tame Impala
Always By Your Side (Nicolas Jaar "Big" Version)	Sneaky Sound System
Always On Time 	Ja Rule
Always Where I Need To Be	The Kooks
Amazed	LoneStar
Ambitionz Az a Ridah	Tupac
America The Beautiful	Ray Charles
American Boy (Estelle cover)	Sam Sparro
American Mourning	Bikini
American Women	Lenny Kravitz
Aminals	Baths
Amor clasificado	Rodrigo
Amor mio	Sabroso
Amsterdam	Peter Bjorn & John
Amsterdam	Peter, Bjorn & John
And I Love Her	The Beatles
And The Beat Goes On	The Whispers
Andy, You're a Star	The Killers
Angel	Jack Johnson
Angelicus  (Morgan Page Remix)	Delerium
Angry Young Man	Get Well Soon
Animal	R.E.M.
Another Day In Paradise	Phil Collins
Anti-D	The Wombats
Any Colour You Like	Pink Floyd
Anyway You Choose To Give It	The Black Ghosts
Anywhere	The Presets
Aparesiste Tu	Los Reyes de Cuarteto
Apart Of You	Kids of 88
Apologize	Kanye West
Apple Tree	Wolfmother
Apúrate José	Teresa Parodi
Aqua Marine	Santana
Araby 	Minks
Are You Devo (The Spirituals Remix)	Shelby Sifers
Armistice	Phoenix
Around My Way	John Legend
ASAP	T.I.
Asi se baila el tango 	Take The Lead
Aspirations	Santana
At My Most Beautiful	R.E.M.
B.O.B.	Outkast
Baby Come Back	Player
Baby Its You (Remix) ft bow wow	Jojo
Baby Mama Love (Album Version)	N2U Feat. Jermaine Dupri
Baby Tell Me I'm the Only One	Thirsty Merc
Back in the U.S.S.R.	The Beatles
Back Then	Mike Jones
Back to Basics	Kanye West
Back Up Offa Me	Talib Kweli
Bad Day	R.E.M.
Bad	Michael Jackson
Bail Me Out	Pete Murray
Baldessari	Fair Ohs
Banana Pancakes	Jack Johnson
Barely Legal	The Strokes
Barrier Break	Diesel Boy + Kaos
Bartender (Feat. Akon)	T-Pain
Basic Expressions	SMH
Bata Bata	Reggeton
Battery	Metallica/San Francisco Symphony Orchestra
Beat It	Michael Jackson
Beautiful Girl	INXS
Beautiful Struggle	Talib Kweli
Been A Long Time (Instrumental)	Capone
Been A Long Time	Capone
Before Destruction	Spoon
Behind the Lines	Phil Collins
Being for the Benefit of Mr. Kite!	The Beatles
Believe Me Natalie	The Killers
Believe	Lenny Kravitz
Berlin	Is Tropical
Bermuda	Kisses
Besos Mojados (La Revolucion)	Wisin & Yandel
Best Friend	50 Cent
Best Of My Love	The Eagles
Better Together	Jack Johnson
Bicycle	Memory Tapes
Billie jean	Michael Jackson
Birth of the Blues	Tommy Emmanuel
Bitter Tears	INXS
Black And Yellow	Wiz Khalifa
Black Dog	Led Zeppelin
Black Girl Pain	Talib Kweli
Black Magic Woman	Santana
Black Or White	Michael Jackson
Black Plant	The Last Shadow Puppets
Black Sweat	Prince
Blame It (Feat T-Pain)	Jamie Foxx
Bleed It Out	Linkin Park
Bleeding Me	Metallica
Blinded By The Light (Album Version)	Manfred Mann's Earth Band
Bling (Confession of a King)	The Killers
Blood Sugar Sex Magic	Red Hot Chilli Peppers
Blood	The Middle East
Blue Moon	Tommy Emmanuel
Boat Behind	Kings Of Convenience
Bonfire	Southern Shores
Bonus Track	The Kooks
Booking Accommodation	SMH
Boombox (ft. Julian Casablancas)	Lonely Island
Borders	The Whitest Boy Alive
Born Fe Rebel	Steel Pulse
Brain Damage	Pink Floyd
Break My Stride	Matthew Wilder
Breaking The Habit	Linkin Park
Breathe	Pink Floyd
Brick House	Kool and the Gang
Brightest Star	Santana
Bring Em Out	T.I.
Bring Me Down	Brandy/Kanye West
Broken Glass	Talib Kweli
Broken Wings	Mr. Mister/Mr. Mister
Broken, Beat And Scarred	Metallica
Brooklyn (Home Demo)	The Kooks
Brother Louie	Talking Modern Lyrics
Brothers	Hot Chip
Bulletproof	The Boat People
Bulls on Parade	Rage Against the Machine
Burn	Usher
Burning	The Whitest Boy Alive
Butterfly	Jason Mraz
Buy You A Drink	T Pain Feat. Yung Joc
By My Side	The Kooks
By The Way	Red Hot Chilli Peppers
Ca Plane Pour Moi	Plastic Bertrand
California Dreamin'	José Feliciano
California Dreaming	Mammas And Pappas
California English	Vampire Weekend
California love	Tupac
Californiacation	Red Hot Chilli Peppers
Call Me Back	The Strokes
Call Me	Kimbra
Call My Name	Morgan Page & Tyler James
Calm Like You	The Last Shadow Puppets
Cameo Lover	Kimbra
Can I Have It Like That ft. Gwen Stefani	Pharrell
Can't Believe It f. Justin Timberlake (Remix)	T-Pain 
Can't Buy Me Love	The Beatles
Can't Judge Me	Mario Winans
Can't You Wait	Geographer
Can`t Stop	Red Hot Chilli Peppers
Canadian Sunset	Tommy Emmanuel
Canción con todos	Cesar Isella
Canned Heat	Jamiroquai
Cap	The Kooks
Cara a Cara	Varios Artists
Carpa salteña	Los cantores del alba
Carry Out	Timbaland Ft Justin Timberlake
Caught Up	Usher
Cayman Islands	Kings Of Convenience
Celebration Day	Led Zeppelin
Celebration	Kool and the Gang
Chains	Kenna
Chamber	The Last Shadow Puppets
Changes	Van She
Changes	Tupac
Chelsworth	Little Red
Chillin With My Bitch Ft Jazze	T.I.
Chinese Freestyle Rap	Tai Mai Shu
Chocolate Raspberry Lemon And Lime	Muscles
Chop Me Up	Justin Timberlake
Church [Clean Version]	T-Pain
Cigarettes in the Theatre	Two Door Cinema Club
Classical Gas (Acoustic)	Tommy Emmanuel
Claude Monet	Thirsty Merc
Coco Jambo [Christmas Version]	Mr. President
Cold War	Vivian Darkbloom
Colossal	Wolfmother
Colours	Phil Collins
Come Back Home	Two Door Cinema Club
Come Fly With Me	Foxy Brown Feat. Sizzla
Come Together	The Beatles
Communication Breakdown	Led Zeppelin
Como Olvidarla	Rodrigo
Compared to What	John Legend;The Roots
Congratulations	Phoenix
Consolation Prizes	Phoenix
Corazon Espinado (Featuring Mana)	Santana/Maná
Corner Of The Earth	Jamiroquai
Cosmic Girl	Jamiroquai
Cotton Mouth	Kids of 88
Count Down	T.I.
Countdown	Phoenix
Courage	The Whitest Boy Alive
Courtesy Laughs	Phoenix
Cousins	Vampire Weekend
Coyotes	Jason Mraz
Crack Music	Game/Kanye West
Crawling [Live]	Linkin Park
Crazy Little Thing Called Love	Michael Bublé
Cross My Heart & Hope To Fly	The Courteeners
Crush	Jennifer Paige
Cry Me A River	Justin Timberlake
Crying Shame	Jack Johnson
Crystalised	The XX
Cuando baje la marea	La Konga
Culpable o no	Sabroso
Cuttin' [Remix]	Mike Jones
Cyanide	Metallica
Damn Girl	Justin Timberlake
Dancing in the Dark	The Temper Trap
Dancing Queen (Queen cover)	Whitley
Dani California	Red Hot Chilli Peppers
Daniel	José Feliciano
Day 'N' Night (Crooker's Remix)	Kid Cudi
Day 'N' Nite	Kid Cudi
Day Tripper	The Beatles
Days of the week	SMH
Daysleeper	R.E.M.
Dazed And Confused	Led Zeppelin
De que te vale	Sabroso
Dead And Gone(ft Justin Timberlake)	T.I.
Dead End	The Whitest Boy Alive
Dead Ending	The Hundred In The Hands
Decadence	Disturbed
Deep In The Forest	Keenhouse
Definitive Breaks	Phoenix
deja de llorar(2)	La champions liga
Descara II (New Version)	Wisin & Yandel feat Yomo
Desde el alma	Ariel Ramirez
Desire Be Desire Go	Tame Impala
Desperado	The Eagles
Details in the Fabric	James Morrison/Jason Mraz
Detects On My Affection	Peter Bjorn And John
Devil's Dance	Metallica
Diamonds And Pearls	Prince
Diamonds from Sierra Leone	Kanye West
Diamonds	Kayne West
Didjerama	Jamiroquai
Didjital Vibrations	Jamiroquai
Dig In	Lenny Kravitz
Digital Girl (Feat The Dream)	Jamie Foxx
Dilemma ft. Kelly Rowland	Nelly
Dime quien	Sabroso
Dime Si Eres Feliz	La Champion Liga
Dime si te vas con el	Nigga
Dimension	Wolfmother
Diplomat's Son	Vampire Weekend
Dirty Laundry  (Morgan Page Remix)	Bitter:Sweet
Disbelief	Mario Winans
Do You Know Where You're Coming From [*]	Jamiroquai
Do You Remember	Jack Johnson
Do You Remember?	Phil Collins
Do You Wanna	The Kooks
Do You Want It All	Two Door Cinema Club
Doesn't Anybody Stay Together Anymore	Phil Collins
Don't Be On With Her	Miami Horror 
Don't Change	INXS
Don't Give Up	The Whitest Boy Alive
Don't Let Me Down	The Beatles
Don't Lose My Number	Phil Collins
Don't stop till you get enough	Michael Jackson
Don't Stop	Tim & Jean
Done With You	The Whitest Boy Alive
Doolin Dalton	The Eagles
Down To The Market	The Kooks
Downtown	Kids of 88
Drifting Along	Jamiroquai
Drive My Car	The Beatles
Drive Slow	GLC/Kanye West/Paul Wall
Droned	Phil Collins
Drop Da Bomb (Yvan Eht Nioj) Megamix	The Simpsons
Drop It Like Its Hot	Snoop Dog
Duke of Earl	The Four Tops
Dvno	Justice
Dy-Na-Mi-Tee	Ms. Dynamite
E-Bow the Letter	R.E.M.
Eat That up, It's Good for You	Two Door Cinema Club
Eaten By Your Love	The Kooks
Eating Out	SMH
Echoplex	Miami Horror
Eclipse Total Del Amor	Varios Artists
Eclipse	Pink Floyd
Eddie's Gun	The Kooks
Eight Days a Week	The Beatles
El federal	La Mona Jimenez
El Señor De La Noche (Original Mix)	Juan Magan & Marcos Rodriguez feat. Manu Gz
El Telefono	Wisin & Yandel
Eleanor Rigby	The Beatles
Electric Feel	Jen Cloher;Jordie Lane
Electricityscape	The Strokes
Electrolite	R.E.M.
Ella Me Llama Tarde	Wisin & Yandel
Emancipate Myself	Thirsty Merc
Embuscade	Phoenix
En Septiembre	Varios Artists
Enamorado de Ella	Varios Artists
Enemy	Jack Johnson
Engañera	Los Tucu Tucu
Enough (Interlude)	Mario Winans
Enter Sandman	Metallica/San Francisco Symphony Orchestra
Enterlude	The Killers
Estoy con ella y pienso en ti	Sabroso
Eucalyptus	The Presets
Europa (Earth's Cry Heaven's Smile)	Santana
Evacuate	The Boxer Rebellion
Evening Glow	Brothertiger
Everybody Hurts	R.E.M.
Everybody Knows	Kids of 88
Everyday I Love You Less And Less	Kaiser Chiefs
Everyday	Jamiroquai
Everything But You	Thirsty Merc
Everything Is Everything	Phoenix
Everything Will Be Alright	The Killers
Evil Ways	Santana
Basic Ex	SMH
Booking	SMH
Eating Out	SMH
Intro	SMH
S & S	SMH
Sightseeing	SMH
T & T	SMH
Exitlude	The Killers
Expectation	Tame Impala
Eyes as Candles	Passion Pit
Fa Fa Fa (Radio Edit)	Datarock
Fa La La	The Kooks
Face	The Black Ghosts
Fade Away	Morgan Page & Matt Wasley
Faint [Live]	Linkin Park
Fall Your Way	Pete Murray
Falling For You	Jem
Fancy Parts	Mr Miyagi
Father To Son	Phil Collins
Feed The Birds	Kids of 88
Feeler	Pete Murray
Fences	Phoenix
Fever	Michael Bublé
Figurate Tu	Rodrigo & Alejandra Romero
Figures	The Whitest Boy Alive
Find A Way To My Heart	Phil Collins
Fired Up.	MC Hush
Fireworks II	The Whitest Boy Alive
Fireworks	The Whitest Boy Alive
Fixing a Hole	The Beatles
Flathead	The Fratellis
Flor d'Luna (Moonflower)	Santana
Flor d'Luna [Moonflower]	Santana
Flossin'	Big Moe/Mike Jones
Fly Away	Lenny Kravitz
Flying High	Jem
Folds in Your Hands	Passion Pit
Follow You There	Little Red
For Everyone	The Ashton Shuffle
For Once In My Life	Michael Bublé
For Reasons Unknown	The Killers
For Whom the Bell Tolls	Metallica/San Francisco Symphony Orchestra
Forever Young	Youth Group
Forget About Your Man	Little Red
Forget My Name (Feat. Hot Chip)	Jesse Rose
Freak Though Ft Pharrell	T.I.
Freak'in Me (Feat Marsha Ambrosius)	Jamie Foxx
Free	Seal
Freedom And Its Owner	Kings Of Convenience
Freedom	Pete Murray
Friday Let Me Down	Hall & Oates
From Me to You	The Beatles
From Paris To Berlin (Pumping For Love)	Infernal
From The Inside [Live]	Linkin Park
Fuck Was I  (Morgan Page Remix)	Jenny Owen Youngs
Fuel	Metallica
Full Moon	Santana
Funky Squaredance	Phoenix
Games	The Strokes
Get A Life	Little Red
Get Back	The Beatles
Get Busy (Remix Cumbia)	Sean Paul
Get Down On It	Kool and the Gang
Get Loose Ft Nelly	T.I.
Get Yo Shit Together Ft L' Kim	T.I.
Getting Better	The Beatles
Ghetto Gospel Feat. Elton John	Tupac
Ghetto Gospel	Tupac
Ghetto Show	Anthony Hamilton/Common/Talib Kweli
Girl	The Beatles
Girlfriend	Phoenix
Girls in Hats (Kissy Sell Out Remix)	The Loose Cannons
Girls Like You	The Naked And Famous
Give It Away	Red Hot Chilli Peppers
Given Up	Linkin Park
Giving Up The Gun	Vampire Weekend
Glamorous Indie Rock & Roll	The Killers
Gloomy Monday Morning	The Black Hollies
Go Bang	SBTRKT
Go On	Jack Johnson
Going Hard	Talib Kweli
Going Wrong	Little Red
Gold Digger featuring Jamie Foxx	Kanye West
Gold Digger	Jamie Foxx/Kanye West
Gold Watch	Lupe Fiasco
Golden Cage	The Whitest Boy Alive
Gone	Cam'ron/Consequence/Kanye West
Good Intent	Kimbra
Good Morning Good Morning	The Beatles
Good people	Jack Johnson
Good Times Bad Times	Led Zeppelin
Goodnight Laura	Spoon
Got It Sewed Up [Remix]	Mike Jones
Got No Love	The Kooks
Got Nuffin	Spoon
Gotta Get Into You	New Young Pony Club
Grand Illusion	Miami Horror
Grandma	Mike Jones
Gratisfaction	The Strokes
Gravity	The Whitest Boy Alive
Green Light	John Legend ft Andre 3000
Grind With Me	Pretty Ricky
Guerilla Radio	Rage Against the Machine
Guru's Song	Santana
Hand in Hand	Phil Collins
Hand Me Down Your Love	Hot Chip
Hand Of Blood	Bullet For My Valentine
Hands Held High	Linkin Park
Hang In Long Enough	Phil Collins
Hang on in There	John Legend;The Roots
Hard Times	John Legend;The Roots
Hard to Explain	The Strokes
Harder to breathe	Maroon 5
Hateful Of Love	The Kooks
Havana Moon	Santana
Hazme el amor	Trulala
Head Above Water	Hall & Oates
Heal the World	Michael Jackson
Heard 'Em Say	Kanye West
Heart Skipped a Beat	The XX
Heartache Tonight	The Eagles
Heartbeats	The Knife
Heartbreaker F. John Legend	MSTRKRFT
Heartbreaker	Led Zeppelin
Heartless	Kanye West
Heat On The Street	Phil Collins
Heatwave	SBTRKT
Hello Goodbye	The Beatles
Hello	Lionel Richie
Help!	The Beatles
Here Comes The Sun	The Beatles
Here I Am [Come And Take Me]	Seal
Here Without You (Acoustic)	Three Doors Down
Here Without You	Three Doors Down
Hermaphrodite	Stephen Lynch
Hero of the Day	Metallica
Hey Jude	The Beatles
Hey Mama	Kanye West
High Heel Sneakers	José Feliciano
High On The Heels	The Whitest Boy Alive
High Times	Jamiroquai
High	The Lighthouse Family
Hit The Floor	Linkin Park
Hit the Road Jack	Ray Charles
Hold On	SBTRKT
Hold The Line	Toto
Holdin' On Together	Phoenix
Holiday	Vampire Weekend
Holidays	Miami Horror
Homesick	Kings Of Convenience
Honeymoon	Phoenix
Hope	Thirsty Merc
Horchata	Vampire Weekend
Horror Movie	Skyhooks
Hotel California	The Eagles
How Can You Mend A Broken Heart	Michael Bublé
How Deep Is Your Love	The Rapture
How Do I Breathe	Mario Barrett
How To Touch A Girl	Jojo
Hoy Te Llame	La Konga
Human	Metallica/San Francisco Symphony Orchestra
Humanity (Love the Way It Should Be)	John Legend;The Roots
Hurt Me	The Jezabels
Hurt So Bad	Little anthony
Hurt Sumthin	Missy Elliott
I Am the Walrus	The Beatles
I Believe	Simian Mobile Disco
I Belong To You	Lenny Kravitz
I Call It Love	Lionel Richie
I Can Show You	Tim & Jean
I Can Talk	Two Door Cinema Club
I Can't Go for That (No Can Do) [12" Version][*]	Hall & Oates
I Can't Go for That (No Can Do)	Hall & Oates
I Can't Stand The Rain	Seal
I Can't Tell You Why	The Eagles
I Can't Wait	Little Red
I Can't Write Left Handed	John Legend;The Roots
I Don't Know	Jamie Foxx
I Don't Like You Anymore	The Last Shadow Puppets
I Don't Need It	Jamie Foxx
I Don't Reall Mind	Tame Impala
I Don't Wanna Know	Phil Collins
i dunno 	Bass Drum Of Death
I Feel Better	Hot Chip
I Feel Fine	The Beatles
I Got A Woman	Ray Charles
Tip
I Got You Babe	Mario Winans
I Just Died In Your Arms Tonight (Remix)	Jay Z
I Like to Move it	Madagascar
I Look To You	Miami Horror
I Love You Much Too Much	Santana
I Missed Again	Phil Collins
I Need You Tonight	INXS
I predict a riot	Kaiser Chiefs
I Saw The Light	Spoon
I Started A Joke	The Bee Gees
I Think Ur A Contra	Vampire Weekend
I Used to Love You	John Legend
I Wanna Be Your Lover	Prince
I Want to Hold Your Hand	The Beatles
I Want You (Girlfriend)	Pretty Ricky
I Want You Back	The John Butler Trio
I Want You	The Kooks
I Will Truck (Dirty Projectors cover)	Painted Palms
I Wish I Knew How It Would Feel to Be Free	John Legend;The Roots
I Wish It Would Rain Down	Phil Collins
I Wish Somebody Would Build a Bridge	Thirsty Merc
I'd Rather Dance With You	Kings Of Convenience
I'm An Actor	Phoenix
I'm Not Moving	Phil Collins
I'm So Excited (remix)	Pointers Sisters
I'm Sprung Feat. Statquo (Instrumental)	T-Pain
I'm Sprung Feat. Statquo	T-Pain
I'm Still In Love With You	Seal
I'm Yours	Jason Mraz
I've Been Loving You Too Long	Seal
Ice Cream	Muscles
If I Ever Feel Better (Todd Edwards Better Dub)	Phoenix
If I Ever Feel Better	Phoenix
If I Had Eyes	Jack Johnson
If I Know You	The Presets
If It Kills Me	Jason Mraz
If It's Not With You	Phoenix
If Leaving Me Is Easy	Phil Collins
If Only	The Kooks
If You Don't Know Me By Now	Simply Red
Ignition (Remix)	R Kelly
Illuminated	Miami Horror
Illuminations	Santana
Im Hot	Young Capone
Imaginate	Wisin & Yandel
Imagination	Miami Horror
Imitation of Life	R.E.M.
Immigrant Song	Led Zeppelin
In Between	Linkin Park
In Da Club (Ft. R Kelly)	Lil' Jon & The East Side Boyz
In Five Years (Niva Remix)	Palpitation
In Love With Dusk	KEEP SHELLY IN ATHENS
In My Bed	Little Red
In My Life	The Beatles
In My Room	The Last Shadow Puppets
In Pieces	Linkin Park
In the Air Tonight	Phil Collins
In The End [Live]	Linkin Park
In the Fire	Mammoth Logic
In the Summertime	Thirsty Merc
In the Water	Beat Connection
Infatuated (Feat. Boxie)	Memphis Bleek
Infinite Canyons	Miami Horror
Inflation	The Whitest Boy Alive
Inside Out	Phil Collins
Intentions	The Whitest Boy Alive
Interplanetary Party	Santana
Into The Night (Featuring Chad Kroeger)	Santana/Chad Kroeger
Into The Sun	Lord Huron
Intro	SMH
Introductions	SMH
Intuition Interlude	Jamie Foxx
Is Love Forever?	Spoon
Is This It	The Strokes
Island In The Sun	Weezer
Island	The Whitest Boy Alive
It Aint Over Til Its Over	Lenny Kravitz
It's A Man's Man's Man's World	Seal
It's Alright	Seal
It's Not Meant To Be	Tame Impala
It's Not Unusual	Tom Jones
Jackie Big Tits	The Kooks
James Dean	The Eagles
January 2 (tanto)	Nathan Edwin
Jenny Was a Friend of Mine	The Killers
Jeremy's Storm	Tame Impala
Jesus Walks	Kanye West
Jesus Walks	Kanye West
Jilly Armeen	Jamie T
Jin-Go-Lo-Ba	Santana
Jingo	Santana
Jitterbug	Wham!
Joker & the Thief	Wolfmother
Jugadoras, Jugadores	La Mala Rodriguez
Just A Little Bit	Kids of 88
Just A Ride	Jem
Just Feel Better (Featuring Steven Tyler)	Santana/Steven Tyler
Just Like Me (Feat T.I)	Jamie Foxx
Kashmir	Led Zeppelin
Katie Q	Thirsty Merc
Keep A Secret	The Whitest Boy Alive
Keep Quiet	Hot Chip
Kicking And Screaming	The Presets
Kicks	Hunting Hat
Killing in the Name	Rage Against the Machine
Kiss From A Rose	Seal
Kiss Kiss [Main Version]	Chris Brown/T-Pain
Kiss Your Ass Goodbye (Instrumental)	Sheek Louch Feat. Styles P.
Kiss	Prince
Kisses	Kisses
Kissing A Fool	Michael Bublé
Kites	Geographer
Knock On Wood	Seal
Know How	Kings Of Convenience
Kryptonite	Three Doors Down
L-O-V-E	Nat King Cole
La amo	Sabroso
La barca	Jambao
La Carta	Varios Artists
La nena (bitacora de un secuestro)	Sabroso
La Revolución (Intro) (Original)	Wisin & Yandel
La tempranera	Los cantores del Quilla Huasi
Ladies Night	Kool and the Gang
Lady (Here me Tonigh)	Modjo
Lady Madonna	The Beatles
Lady	Lenny Kravitz
Lasso	Phoenix
Last night a dj saved my life	Indeep
Last Nite	The Strokes
Late	Kanye West
Latin Songs (Mix)	Salsa
Laws Patrolling	CJ/Lil' Bran/Mike Jones
Lazy Boy	Little Red
Leave out All the Rest	Linkin Park
Leave	Jojo
Your Not Hardcore	Jack Black
Let It Be	The Beatles
Let Them	jj
Let Your Love Grow Tall	Passion Pit
Let's Call It Off	Peter Bjorn And John
Let's Move	The Perceptionists
Lets get blown 	Snoop Dog
Life In The Fast Lane	The Eagles
Life Is a Lady	Santana
Life Is Simple In The Moonlight	The Strokes
Light My Fire	José Feliciano
Lightnin'	Santana
Like Snow	Thirsty Merc
Like This And Like That	Snoop Dogg
Like U	Snoop Dog
Limbo	Kimbra
Limelight Ft PC and Big Kuntry	T.I.
Lines	Pete Murray
Lisa It's Your Birthday	Michael Jackson
Listen Like Thieves	INXS
Lisztomania (Yuksek Remix)	Phoenix
Lisztomania	Phoenix
Little Bit Of Something	Little Red
Little Ghetto Boy (Prelude)	John Legend;The Roots
Little Ghetto Boy	John Legend;The Roots
Little girl 'Dark Night of the Soul'	Julian Casablancas
Little Red Corvette	Prince
Little Secrets	Passion Pit
Live High	Jason Mraz
Live Your Life(ft rhianna)	T.I.
Livin It Up	Ja Rule
Living In The 70's	Skyhooks
Living La Vida Loca	Ricky Martin
Living Together (In Sin)	The Whispers
Lollipop [Radio Edit]	Lil Wayne/Static Major
Long Distance Call	Phoenix
Long Long Way To Go	Phil Collins
Longest Road	Morgan Page & Lissie
Looking for a Good Sign	Hall & Oates
Loose Wires/Blink Radio	Kenna
Lopez Pereyra	Los Fronterizos
Losing Keys	Jack Johnson
Losing My Religion	R.E.M.
Losing My Way	Justin Timberlake
Lost And Found	Phoenix
Loud Mouths (Supreme Cuts Mix)	Wise Blood
Love Brings Change (Bonus Track)	Jamie Foxx
Love for a Child	Jason Mraz
Love For Granted	Phoenix
Love Is No Big Truth	Kings Of Convenience
Love It All	The Kooks
Love Like A Sunset Part I	Phoenix
Love Like A Sunset Part II	Phoenix
Love Make	Dog And Panther
Love Me Do	The Beatles
Love	Foster The People
Lovely Rita	The Beatles
Lucidity	Tame Impala
Lucky	Colbie Caillat/Jason Mraz
Lucy in the Sky With Diamonds	The Beatles
Lullabye	Stephen Lynch
Lump Sum Of Paris (Bon Iver vs Friendly Fires & Aeroplane)	The Hood Internet
Lyin' Eyes	The Eagles
Lying From You [Live]	Linkin Park
Macarena	Los Del Rio
Machu Picchu	The Strokes
Magical Mystery Tour	The Beatles
Make It Better	The Knocks
Make It Mine	Jason Mraz
Make It With You	The Whispers
Make Light	Passion Pit
Make You Mine	Miami Horror
Makes Me Wonder	Maroon 5
Maldita hermosa	Sabroso
Mama Said	Lenny Kravitz
Man in the Mirror	Michael Jackson
Man on the Moon	R.E.M.
Manamana	Animal & The Muppets
Maneater  (Morgan Page Remix)	Nelly Furtado
Maneater	Hall & Oates
Manhattan Skyline	Kings Of Convenience
Mano a Mano	Hall & Oates
Mañana	Wisin & Yandel
Maria Maria (Featuring The Product G&B)	Santana/Product G&B
Master of Puppets	Metallica
Matchbox	The Kooks
Me Da Pena	Sabroso
Me haz vuelto loco	Sabroso
Me In You	Kings Of Convenience
Meeting Place	The Last Shadow Puppets
Mess Around	Ray Charles
Message In A Bottle (Acoustic)	John Mayer
Message In A Bottle	Sting & The Police
Metabolism	The Strokes
Mi mundo sin ti	Sabroso
Mi Swing Es Tropical	Quantic & Nickodemus
Michelle	The Beatles
Midnight City	M83
Midnight Show	The Killers
Millionaire Feat Andre 3000	Kelis
Mind's Eye	Wolfmother
Mirage	Santana
Misread	Kings Of Convenience
Missing You	Jem
Mistaken For Strangers	The National
Misty Mountain Hop	Led Zeppelin
Modern Way	Kaiser Chiefs
Mon Meilleur Ami	Yelle
Money	Pink Floyd
Monsoon	Jack Johnson
Moon Theory	Miami Horror
Moondance	Michael Bublé
Moth's Wings	Passion Pit
Motivation	T.I.
Move Your Feet	Junior Senior
Mr. Brightside	The Killers
Mr. Maker	The Kooks
Mrs Cold	Kings Of Convenience
Mrs Robinson	Simon and Garfunkel
Muevelo ( New 2009) 	Wisin & Yandel
Mule Skinner Blues	José Feliciano
Murder Room	Pepper Rabbit
Must get out	Maroon 5
My Apocalypse	Metallica
My Boo	Usher Feat Alicia Keys
My Cabal	School of Seven Bells
My Completeness	Thirsty Merc
My House	Kids of 88
My Life Ft Daz Dillinger	T.I.
My List	The Killers
My Love	Justin Timberlake
My Mistakes Were Made For You	The Last Shadow Puppets
My People	The Presets
My Ship Isn't Pretty	Kings Of Convenience
My Time	Pete Murray
Nadie como tu	Wisin & Yandel
Naïve	The Kooks
Napoleon Feat. Xiu Xiu	Sole And The Skyrider Band
Napoleon Says	Phoenix
Nasty Girl	Notorious B.I.G
Necesito que Vuelva	Sabroso
Nervous In The Light Of Dawn  (Morgan Page Remix)	Leigh Nash
Never Been in Love	Talib Kweli
Never Go Get It	Sean Biggs feat. Topic and Akon
Never Never	SBTRKT
Never Really Was	Mario Winans
Never Tear Us Apart	INXS
New Beat	Toro Y Moi
New Kid In Town	The Eagles
New Sensation	INXS
New Soul (Ft. Yael Naim	Wale
New Theory (Washed Out cover)	Teen Daze
New Theory	Washed Out
New York City Cops	The Strokes
Nightswimming	R.E.M.
Nikki (I Am Not The-Dream)	Gobble Gobble
Nine Thou (Superstars Remix)	Styles of Beyond
No Es Solo Sexo	Sabroso
No Leaf Clover	Metallica
No Longer	The Kooks
No More Sorrow	Linkin Park
No One To Depend On	Santana
No Scrubs	TLC
No Sex For Ben	The Rapture
No Shelter	Rage Against the Machine
No Surprises	Regina Spektor
No te lloro mas	Gocho Feat Arcangel
No te pertenece	Los Clasiqueros
Nobody Gets Me But You	Spoon
Noche De Sexo	Wisin & Yandel
North	Phoenix
Norwegian Wood (This Bird Has Flown)	The Beatles
Not a Criminal	Chamillionaire/Kelis
Not coming home	Maroon 5
Not Many (Remix)	Scribe
Not That Kinda Girl	Jojo
Nothing Else Matters	Metallica/San Francisco Symphony Orchestra
Nothing Ever Changes	The Kooks
Nowhere Man	The Beatles
Numb [Live]	Linkin Park
Number One (Feat Lil' Wayne)	Jamie Foxx
Number One Spot	Ludacris
Number One	John Legend
Numbers	SMH
Ob-La-Di, Ob-La-Da	The Beatles
Ocho cuarenta	Rodrigo
Octopus's Garden	The Beatles
Of Wolf and Man	Metallica
Oh My God [Technoboy's Callsheet]	Shayla/Technoboy
Oh My God	Kaiser Chiefs
Ojala Que No Puedas	Sabroso
Old Brown Shoe	The Beatles
Old Flame	Kimbra
Ole, Ole, Ole	Ricky Martin
On Fire	Phoenix
On the Run	Pink Floyd
On Top	The Killers
One Day At A Time	Tupac
One Day	Morgan Page & Camila Grey
One Good Reason	Celldweller
One Last Time	The Kooks
One Life Stand	Hot Chip
One More Night	Phil Collins
One Of These Nights	The Eagles
One Step Closer [Live]	Linkin Park
One Time Too Many	Phoenix
One	Metallica
Only Human	Jason Mraz
Only The Truth	The Last Shadow Puppets
Only You Know And I Know	Phil Collins
Ooh La	The Kooks
OOOO	Fishing
Opportunity	Pete Murray
Orange Crush	R.E.M.
Ordinary People	John Legend
Otra Vez	Varios Artists
Our Generation (The Hope of the World)	John Legend;The Roots
Out Go The Lights	Spoon
Out Of Control (State Of Emotion)	Kenna
Out of the Blue	Julian Casablancas
Outlaw Torn	Metallica/San Francisco Symphony Orchestra
Outro	SMH
Outta Control (Remix Instrumental)	50 Cent
Outta Control (Remix)	50 Cent
Overdose	Jamie Foxx
Oye Como Va (Paul Oakenfold Mix-Digital Bonus Track)	Santana
P5hing Me A*Wy [Live]	Linkin Park
Papa Loves Mambo	Perry Como
Paperback Writer	The Beatles
Papercut [Live]	Linkin Park
Party Starter	Will Smith Feat Ludacris
Party Time	Phoenix
Peace And Hate (Morgan Page Remix)	Submarines
Peacetime Resistance	Kings Of Convenience
Peacful Easy Feeling	The Eagles
Penny Lane	The Beatles
People Can Do The Most Amazing Things	Kisses
People Get Ready	Seal
Perfect Situation	Weezer
Perfect Strangers	INXS
Permitame 	Wisin & Yandel
Perro Ajeno	Sabroso
Persuasion	Santana
Pharoahs	SBTRKT
Pictures	Sneaky Sound Systems
Pimpin' All Over The World(Ft.	Ludacris
Pimpin' All Over The World	Ludacris
Place Called Love	Little Red
Plain Gold Ring	Kimbra
Play (Instrumental)	David Banner
Play Play	y/y
Play	David Banner
Please Please Me	The Beatles
Please	Pete Murray
Points Of Authority [Live]	Linkin Park
Polyester Girl	Regurgitator
Power Of Not Knowing	Kings Of Convenience
Praying For Help	T.I.
Precisamente Con El	Sabroso
Pretend	The Brandt Brauer Frick Ensemble
Pretty Girl Bullsh*t	Foxy Brown/Mario Winans
Pretty Vegas	INXS
128kbps	Prince
Private Eyes	Hall & Oates
Promise less or do more	The Whitest Boy Alive
Psychic Chasms	Neon Indian
Punching In A Dream	The Naked And Famous
Pursuit of Happiness	Cloud Control
Put Cha Hands Up	KP & Envyi
Put Your Head On My Shoulder	Michael Bublé
Put Your Lights On (Featuring Everlast)	Santana/Everlast
Pyramid	Wolfmother
Que Ironia	Rodrigo
Que me diera	Sabroso
Que no	Sabroso
mix	La Konga
Quizas	Wisin & Yandel
Rain	José Feliciano
Rainman	Jamie Foxx
Rakata	Wisin & Yandel
Rally	Phoenix
Ramble On	Led Zeppelin
Rap Song feat. Rick Ross	T-Pain
Read My Mind	The Killers
Ready for Love (Interlude)	Mario Winans
Ready Set Loop	SBTRKT
Real love	Delorean
Regulators	Warren G and Nate Dogg
Remeneate	Sabroso
Renegade	Kings Of Convenience
Renegades of Funk	Rage Against the Machine
Revelations	Santana
Revolution	The Beatles
Ribbons Of Light	Kids of 88
Right Here Waiting	José Feliciano
Right Thing to Do	SBTRKT
Riot On An Empty Street	Kings Of Convenience
Road Trippin'	Red Hot Chilli Peppers
Rock And Roll	Led Zeppelin
Rock It	Little Red
Rock With You	Michael Jackson
Rock Your Body	Justin Timberlake
Rollercoaster Ride	The Whitest Boy Alive
Rome	Phoenix
Rosanna	Toto
Roses	Kanye West
Ruby	Kaiser Chiefs
Rule My World	Kings Of Convenience
Run Run Run	Phoenix
Run	Vampire Weekend
Runaway [Live]	Linkin Park
Runaway, Houses, City, Clouds	Tame Impala
Running Away From Me	Release The Sunbird
Running Romeo	Gypsy & The Cat
Sacala	Wisin & Yandel
Sad But True	Metallica/San Francisco Symphony Orchestra
Sahara Mahala	The Jezabels
Sam's Town	The Killers
Samba !	Tomboy
Samba Pa Ti	Santana
Samba Pa' Ti	Santana
Same Girl	Jack Johnson
San Fran	Kids of 88
Sanctuary	SBTRKT
Santeria	Various Artists
Santo pecado	Ricardo Arjona
Saturday Night And Sunday Morning	Phil Collins
Save Room	John Legend
Savor	Santana
Say Goodbye To Love	Kenna
Say You, Say Me	Lionel Richie
Say	John Mayer
Scandalous Hoes	Lil' Bran/Mike Jones
Scar Tissue	Red Hot Chilli Peppers
Scars On Land	Kings Of Convenience
School's Rules	Phoenix
Schoolyard	Wintermitts
Scream	Mercy Arms
Screw Dat	Mike Jones
Se Parece Mas a Ti	jambao
Searching Through The Past	Bleached
Seaside	The Kooks
Seaweed Song	Passion Pit
Second To None	Phoenix
Second To Numb	Kings Of Convenience
Secret Love	Jojo
Secret	Maroon 5
See The Sun (Alternate Version)	The Kooks
See The Sun	The Kooks
See the World	The Kooks
Senorita	Justin Timberlake
Separate And Ever Deadly	The Last Shadow Puppets
Sera porque te amo	Sabroso
Settle Down	Kimbra
Sex	JayKo
Sexy Ladies (Feat. 50 Cent)	Justin Timberlake
Sexyback (DJ Wayne Williams Ol Skool Remix) (Feat. Missy Elliott)	Justin Timberlake
Sexyback	Justin Timberlake
Sgt. Pepper's Lonely Hearts Club Band (Reprise)	The Beatles
Sgt. Pepper's Lonely Hearts Club Band	The Beatles
Shades of Time	Santana
Shadow of the Day	Linkin Park
Shadows	Warpaint
Shake	The Golden Filter
Shapeshifter	Celldweller
Shawty Get Loose [Main Version]	Chris Brown/Lil' Mama/T-Pain
She Bangs	Ricky Martin
She Got Her Own (Feat Ne-Yo And Fabolous)	Jamie Foxx
She Loves You	The Beatles
She Moves in Her Own Way	The Kooks
She will be loved	Maroon 5
She's a Lady	Tom Jones
She's A Maniac	Hall & Oates
She's a Rich Girl	Hall & Oates
She's Leaving Home	The Beatles
She's Not There	Santana/Greg Walker
Shine On	The Kooks
Shine	John Legend;The Roots
Shiver	Maroon 5
Shopping and Services	SMH
Should've Known	Mario Winans
Si me Dejas No Vale	Nolberto & Alcala
Si se calla el cantor	Horacio Guarany
Sightseeing	SMH
Signs	Snoop Dog
Siguelo	Wisin & Yandel
Sin Control	Los Clasiqueros
Sin ti la Vida	Wisin & Yandel
Since I'Ve Been Loving You	Led Zeppelin
Sing It Back	Moloko
Singing In The Rain (Remix)	Mint Royale Ft. Gene Kelly
Sitting, Waiting, Wishing	Jack Johnson
Skinnyman	Static-X
Skit #1	Kanye West
Skit #2	Kanye West
Skit #3	Kanye West
Skit #4	Kanye West
Sky Dive	Sunvisor
Women In Uniform	Skyhooks
You Just Like Me 'Cos I'm Good in Bed	Skyhooks
Sleep now in the fire	Rage Against the Machine
Sleep Through the Static	Jack Johnson
Sleepwalkers	The Hundred In The Hands
Sleepwalking Through The Mekong  (Morgan Page Remix)	Dengue Fever
SleepyHead (Neo Tokyo Remix )	Passion Pit
Sleepyhead	Passion Pit
Slow Motion	Little Red
Slow	Jamie Foxx
Slush	Hot Chip
Smile Like You Mean It	The Killers
Smooth (Featuring Rob Thomas)	Santana/Rob Thomas
Smooth Criminal	Michael Jackson
Snap Yo Fingers feat Lil' Wayne	T-Pain
So Beautiful	Pete Murray
So Fine	Mario Winans
So Happy Together	The Beatles
So High	Van She
Soak It Up	Houses
Sobrevivire	Varios Artists
Sofa Song	The Kooks
Soft Light	Miami Horror
Solitude is Bliss	Tame Impala
Solos Tu Y Yo	Wisin & Yandel
Soma	The Strokes
Some Men	Hall & Oates
Somebody Told Me	The Killers
Someday, Someday	Thirsty Merc
Someday	The Strokes
Something Goes Right	SBTRKT
Something Good Can Work	Two Door Cinema Club
Something Happened On The Way To Heaven	Phil Collins
Something	The Beatles
Sometimes In The Fall	Phoenix
Sometimes	Miami Horror
Somewhere I Belong [Live]	Linkin Park
Sorry Or Please	Kings Of Convenience
SOS (Rhianna Cover)	The Last Shadow Puppets
Soul Sacrifice	Santana
Spanish Girl	La Konga 
Speak to Me	Pink Floyd
Spend a Lifetime	Jamiroquai
SQRL	Kids of 88
Stairway To Heaven	Metallica
Stand By Me	Seal
Stand Up Ft Lil Wayne & Trick	T.I.
Stand	R.E.M.
Standing Next To Me	The Last Shadow Puppets
Starlight	Superman Lovers
Start To Melt	Peter Bjorn And John
Stay And Defend	Wolf Gang
Stay Out Of Trouble	Kings Of Convenience
Stay with Me	José Feliciano
Stay With You	John Legend
Stayin Alive	The Bee Gees
Steel String Rag	Tommy Emmanuel
Stick That Thing Out	Lil' Jon & The East Side Boyz
Still Tippin'	Mellow/Mike Jones/Paul Wall
Stop The Music	Scribe
Stormy Weather	The Kooks
Strangers	Van She
Strawberry Fields Forever	The Beatles
Strict Machine	Band of Skulls
Suave (Remix)	Residente Calle 13
Sugar Pie Honey Bunch	The Temptations
Suicide And Redemption	Metallica
Suicide Blonde	INXS
Summer Days	Phoenix
Summer Wind	Michael Bublé
Summersun	Miami Horror
Sunday morning	Maroon 5
Sunndreamm	Millionyoung
Superhero	Stephen Lynch
Surprise Ice	Kings Of Convenience
Sussudio	Phil Collins
Swagga Like Us	T.I
Sway	The Kooks
Sweaty	Muscles
Sweet Disposition	The Temper Trap
Sweet Dreams	Annie Lenox
Sweetest goodbye	Maroon 5
Swimming In the Flood	Passion Pit
Take a Walk on the Wild Side	Lou Reed
Take It Easy	The Eagles
Take It In	Hot Chip
Take It or Leave It	The Strokes
Take It To The Limit	The Eagles
Take Me Home	Phil Collins
Take On Me	A-Ha
I Like That You Cant Take That Away From Me	Jae Millz June Christy Eric B And Rakim And Mashonda
Take Your Shirt Off	T-Pain
Taken For A Fool	The Strokes
Tales From the Forest Of Gnomes	Wolfmother
Tales of Kilimanjaro	Santana
Talk Like That	The Presets
Tan Que Tan	Trulala
Tangled	Maroon 5
Tarantula / Holding on	Delay Trees
Tarzon Boy	Los Clasiqueros
Taxi Cab	Vampire Weekend
Taylor	Jack Johnson
Te amo	La champions liga
Te veo mañana	Los Reyes Del Cuarteto
Te Voy a Enseñar	La Mona Jimenez
Tease Me	Sneaky Sound Systems
Teenage Girls  	Bleeding Knees Club
Tell Me What You Want	Hall & Oates
Telling the time	SMH
Ten Ft Tall	Pete Murray
Ten paciencia	talhia y daddy yanke
Tequila Sunrise	The Eagles
Testify	Rage Against the Machine
Tha King	T.I.
That Was Just Your Life	Metallica
That's All	Michael Bublé
That's Just The Way It Is	Phil Collins
The A La Menthe	Nikkfurie
The Age Of The Understatement	The Last Shadow Puppets
The Ballad of John and Yoko	The Beatles
The Basket	Guillemots
The Battle Of Evermore	Led Zeppelin
The Bay (Clock Opera Remix)	Metronomy
The Bold Arrow of Time	Tame Impala
The Build Up	Kimbra
The Call of Ktulu	Metallica
The Chamber	The Last Shadow Puppets
The Chills	Peter Bjorn And John
The Day That Never Comes	Metallica
The Dynamo of Volition	Jason Mraz
The Ecstasy of Gold	Metallica
The End Of The Line	Metallica
The Fog Rose High	Craft Spells
The Fool on the Hill	The Beatles
The Game Of Love (Featuring Michelle Branch)	Santana/Michelle Branch
The Game Of Love (Featuring Tina Turner)	Santana/Tina Turner
The Getaway (Athlete Re-Work)	Athlete
The Ghostship	Collarbones
The Gift	INXS
The Great Beyond	R.E.M.
The Great Gig in the Sky	Pink Floyd
The Greatest Ft Mannie Fresh	T.I.
The Judas Kiss	Metallica
The King And All Of His Men	Wolf Gang
The Last Time	José Feliciano
The Little Things Give You Away	Linkin Park
The Logical Song	Miami Horror
The Long and Winding Road	The Beatles
The Long Run	The Eagles
The Look	Metronomy
The Memory Remains	Metallica
The Modern Age	The Strokes
The Mystery Zone	Spoon
The Pedestrian Boogie	The Bloodsugars
The Pick Of Destiny	Tenacious D
The Reeling	Passion Pit
The Roof Is Leaking	Phil Collins
The Rouge Became	Bronze
The Saints are comming	U2 and GreenDay
The Sidewinder Sleeps Tonite	R.E.M.
The sun	Maroon 5
The Thing That Should Not Be	Metallica
The Thong Song	Sisqo
The Time Has Come Again	The Last Shadow Puppets
The Time Is Now	Moloko
The Unforgiven III	Metallica
The Wake Up Song	The Submarines
The Walk	The Cure
The Way You Look Tonight	Michael Bublé
The Way You Make Me Feel	Michael Jackson
These Days	Rhymefest
They Do, They Don't	Jack Johnson
They	Jem
Thieves In The Night	Hot Chip
This Boy's Fire (Featuring Jennifer Lopez & Baby Bash)	Santana/Baby Bash/Jennifer Lopez
This Boy's In Love	The Presets
This I Promise You	Ronan Keating
This is the Life	Two Door Cinema Club
This Is the Thanks I Get	Black Rob/Mario Winans
This love	Maroon 5
This Must Be Love	Phil Collins
This River Is Wild	The Killers
Thriller	Michael Jackson
Through with you	Maroon 5
Thunder and Lightning	Phil Collins
Tick Of Time	The Kooks
Ticket to Ride	The Beatles
Tilted	Lupe Fiasco
Time After Time	José Feliciano
Time Awaits	The Kooks
Time To Pretend	MGMT
Time	Pink Floyd
Timebomb	The Whitest Boy Alive
To Catch a Thief	SPORTS
To Kingdom Come	Passion Pit
Together	The Presets
Tomorrow Never Knows	Phil Collins
Tonic	Pete Murray
Too Hot	Kool And The Gang
Too Little Too Late	Jojo
Too Much To Do	Sparkadia
Too Young (Zoot Woman Remix)	Phoenix
Too Young	Phoenix
Tooth Decay	Black Moth Super Rainbow
Touch the Sky	Kanye West/Lupe Fiasco
Track 01	The XX
Trago de sombra	Los de Salta
Transcendance	Santana
Transformation Day	Santana
Transport and Travel	SMH
Travelling Without Moving	Jamiroquai
Treat Her Like A LAdy	Joe
Treat	Santana
Treats	Sleigh Bells
Tres	Trulala
Trials of the Past	SBTRKT
Tribute	Tenacious D
Trouble Comes Running	Spoon
Trying Your Luck	The Strokes
Tu me vas a dejar	La Konga
Tu Sabes	Wisin & Yandel
Tu Vives En Mi	Wisin & Yandel
Turn Around	Mario Winans
Turning Lane	Mike Jones
TV 	True Live
Twenty One One Zero	Phoenix
Two Kinds Of Happiness	The Strokes
Two Way Street	Kimbra
Type of Nigga U Need	Brighteyes/Mike Jones
U Don't Know Me	T.I.
U Got The Look	Prince
Ultraviolet	Miami Horror
Un dia te querré	Zamba Quipildor
Uncle Jonny	The Killers
Under  (Morgan Page Remix)	Under
Under Cover Of Darkness	The Strokes
Under the Bridge	Red Hot Chilli Peppers
Under	Tito El Bambino
Undercover Martyn	Two Door Cinema Club
Undivided Love	Thirsty Merc
Unenjoyment	Integral Plateau
Unfinished Business	Mumford & Sons
Unforgettable	Nat King Cole
Unguarded Minute	Hall & Oates
Uno de Noviembre	Odio París
Until It Sleeps	Metallica/San Francisco Symphony Orchestra
Until The End Of Time (Duet With Beyonce)	Justin Timberlake
Until The End Of Time	Justin Timberlake
Upside Down	Jack Johnson
Us and Them	Pink Floyd
Use the Force	Jamiroquai
Vagabond	Wolfmother
Valentine's Day	Linkin Park
Ven Bailalo	Khriz y Angel
Venice Beach (Germany Germany remix)	Futurecop!
Victim Of The Crime	Phoenix
Virtual Insanity	Jamiroquai
Vivir sin tu amor	Sabroso
Vuela	Varios Artists
Waiting	Santana
Wake Up Everybody	John Legend;The Roots
Wake Up Mr. West	Kanye West
Wake Up	Rage Against the Machine
Wake	Linkin Park
Walk Alone	Jack Johnson
Walk on the Wild Side	Yves Klein Blue
Walking On Fire	Apache Beat
Wandering Limbs	Kimbra
Wasting Time	Thirsty Merc
Watching Me, Watching You	Gypsy & The Cat
Watching The Ships Roll In	The Kooks
We Belong Together (Remix)  ft. Styles P. & Jadakiss	Mariah Carey
We Can Make It Better	Kanye West
We Can Work It Out	The Beatles
We Control	Hyper
We Don't Walk	The Paper Scissors
We Have Love	Hot Chip
We Major	Kanye West/Nas/Really Doe
We No Speak Americano	Yolanda Be Cool & DCUP
We Own The Sky	M83
We Said Hello Goodbye	Phil Collins
Weekend Lover	Jamie Foxx
Weightless	Waylayers
What I've Done	Linkin Park
What It Iz	The Cool Kids
What They Do Ft B.G.	T.I.
What You Know	Two Door Cinema Club
What You Thought You Need	Jack Johnson
What'd I Say	Ray Charles
What's the Frequency, Kenneth?	R.E.M.
What's Wrong With Me	Mario Winans
Whateva	Remy Ma
Whatever You Like	T.I.
When Doves Cry	Prince
When I'm Sixty-Four	The Beatles
When To Let Go	Violens
When You Were Young	The Killers
Where Are We Runnin' ?	Lenny Kravitz
Where Eagles have been	Wolfmother
Where's Your Head At? [Klaas Remix]	Jean Elan
Wherever I May Roam	Metallica/San Francisco Symphony Orchestra
While My Guitar Gently Weeps	The Beatles
While We Wait	Jack Johnson
Whirlwind	Death In Plains
White Sky	Vampire Weekend
White Unicorn	Wolfmother
Who Makes Your Money	Spoon
Who Said I Would	Phil Collins
Whole Lotta Love	Led Zeppelin
Wholy Holy	John Legend;The Roots
Whose Side Are You On Anyway?	Absofacto
Why Do I Keep Counting?	The Killers
Why Don't You & I (Featuring Alex Band Of The Calling)	Santana/Alex Band
Why Won't You Make Up Your Mind?	Tame Impala
Why You Mad At Me	T.I.
Why	Jamie Foxx
Wild 2Nite	Shaggy Feat. Olivia
Wild Palms	Sun Airway
Wild Thing	Steppenwolf
Wildfire	SBTRKT
Wings Out	Glowbug
Wish I	Jem
wisin & yandel-abusadora359	Wisin & Yandel
Witchy Woman	The Eagles
With a Little Help from My Friends	The Beatles
Withcraft	Wolfmother
Withdraw	Kimbra
Within You Without You	The Beatles
Woman	Wolfmother
Wonderboy	Tenacious D
Work 	Kelly Rowland 
Work It Out	Talib Kweli
Working for the Weekend	Loverboy
Written In Reverse	Spoon
Y sentir tal vez	Sabroso
Ya Ya (Al Stone Mix)	The Empty Heads
Yeah	Usher Feat. Lil' Jon and Ludac
Yellow Submarine	The Beatles
Yesterday	The Beatles
Yippyo-ay	The Presets
Yo Voy (Version 2009)	Zion & Lennox Feat Daddy Yanke
You And I (Deadmau5 Mix)	Medina
You and I (feat. Caroline Polachek)	Washed Out
You Are Mine	Mute Math
You Are My Love	Jamiroquai
You Can't Hurry Love	Phil Collins
You Don't Love Me	The Kooks
You Just Don't Care	Santana
You Knew	Mario Winans/Slim
You Know What I Mean	Phil Collins
You Must Follow (Evol Intent VIP)	Stratus
You Only Live Once	The Strokes
You Send Me	José Feliciano
You Wish You Were Red	Trailer Trash Tracys
You'll Be In My Heart	Phil Collins
You'll Be Under My Wheels	The Prodigy
You'll Never Find Another Love Like Mine	Michael Bublé
You're Not Stubborn	Two Door Cinema Club
You're So Right	The Strokes
You've Got to Hide Your Love Away	The Beatles
Young Fly and Flashy	Young Capone
Young Folks	Peter, Bjorn & John
Young Intentions (Feat. Goddamn Electric Bill)	Immoor
Your Body Is a Wonderland	John Mayer
Your Body	Pretty Ricky
Your Imagination [12" Version][*]	Hall & Oates
Your Imagination	Hall & Oates
Your Own Worst Enemy	Broadcast 2000
Zepher Song	Red Hot Chilli Peppers
Zimbabwe 	New Navy
Crystalized (Cover)	Gorillaz
Danza Kuduro (Feat. Lucenzo)	Don Omar
Don't Worry We'll Be Watching You	Gotye
Easy Way Out	Gotye
Eyes Wide Open	Gotye
Giving Me A Chance	Gotye
I Feel Better	Gotye
In Your Light	Gotye
Making Mirrors	Gotye
Save Me	Gotye
Smoke And Mirrors	Gotye
Somebody That I Used To Know (Loot & Plunder Remix)	Gotye
Somebody That I Used To Know	Gotye
State Of The Art	Gotye
Bronte	Gotye
Born Again (Intro)	The Notorious B.I.G
N.O.T.O.R.I.O.U.S.	The Notorious B.I.G
Dead Wrong	The Notorious B.I.G
Hope You Niggas Sleep	The Notorious B.I.G
Dangerous MC's	The Notorious B.I.G
Biggie	The Notorious B.I.G
Niggas	The Notorious B.I.G
Big Booty Hoes	The Notorious B.I.G
Would You Die For Me? (feat. Lil' Kim & Puff Daddy)	The Notorious B.I.G
Come On	The Notorious B.I.G
Rap Phenomenon	The Notorious B.I.G
Let Me Get Down	The Notorious B.I.G
Tonight	The Notorious B.I.G
If I Should Die Before I Wake	The Notorious B.I.G
Who Shot Ya?	The Notorious B.I.G
Can I Get Witcha	The Notorious B.I.G
I Really Want To Show You	The Notorious B.I.G
Ms. Wallace (Outro)	The Notorious B.I.G
B.I.G. Live In Jamaica (Intro)	The Notorious B.I.G
It Has Been Said (feat. Diddy, Eminem, Obie Trice)	The Notorious B.I.G
Spit Your Game (feat. Twista, Bone Thugs N Harmony)	The Notorious B.I.G
Whatchu Want (feat. Jay-Z)	The Notorious B.I.G
Get Your Grind On (feat. Big Pun, Fat Joe, Freeway)	The Notorious B.I.G
Living The Life (feat. Snoop Dogg, Ludacris, Faith Evans, Cheri Dennis, Bobby Valentino)	The Notorious B.I.G
The Greatest Rapper (Interlude)	The Notorious B.I.G
1970 Somethin' (feat. The Game, Faith Evans)	The Notorious B.I.G
Nasty Girl (feat. Diddy, Nelly, Jagged Edge, Avery Storm)	The Notorious B.I.G
Living In Pain (feat. 2Pac, Mary J. Blige, Nas)	The Notorious B.I.G
I'm With Whateva (feat. Lil Wayne, Juelz Santana, Jim Jones)	The Notorious B.I.G
Beef (feat. Mobb Deep)	The Notorious B.I.G
Hustler's Story (feat. Scarface, Akon, Big Gee)	The Notorious B.I.G
Breakin' Old Habits (feat. T.I., Slim Thug)	The Notorious B.I.G
Ultimate Rush (feat. Missy Elliot)	The Notorious B.I.G
Mi Casa (feat. R. Kelly, Charlie Wilson)	The Notorious B.I.G
Little Homie (Interlude)	The Notorious B.I.G
Hold Ya Head (feat. Bob Marley)	The Notorious B.I.G
Just A Memory (feat. The Clipse)	The Notorious B.I.G
Wake Up (feat. KoRn)	The Notorious B.I.G
Love Is Everlasting (Outro)	The Notorious B.I.G
De Javu	Lindstrom
Can't Let Anybody Know Who You Are	Evan Voytas
DIY	Keep Shelly In Athens
Know No Violence (Sun Glitters Remix)	Spanish Prisoners
Red Song	Suuns
Be Gone	Tara Simmons
Take It In	Wye Oak
Never Had Nobody Like You	M. Ward
Fake Pretend (feat. Marissa Nadler)	Carter Tanton
Serpents	Sharon Van Etten
Madeleine	Lissy Trullie
Control	The Mission In Motion
Counter Revolution	The Delta Riggs
Love Letter	Clairy Browne and the Bangin' Rackettes     
Sexual Lifestyle	Strange Talk
Good Thing (feat. Mr Hill)	Seven
Paris Collides	RUFUS
Miracle Mile	Expatriate
I Got A Letter	Kill City Creeps
The Lie Is	Guineafowl
Always Looking	Dum Dum Girls
Los Reyes Magos	Mercedes Sosa	A La Huella La Huella
Los Reyes Magos	Mercedes Sosa
Felice Navidad	The Wiggles
Villancico anónimo Argentino	Huachito Torito
Dulce Jesús Mio	Villancicos
Ocean Deep	Cliff Richard
Some People	Cliff Richard
We Don't Talk Anymore	Cliff Richard
Missing You	John Waite
All By Myself	Cliff Richard	When I See You Smile
Go Outside	Cults
Helplessness Blues	Fleet Foxes
Vomit	The Girls
Holocene	Bon Iver
Baby's Arms	Kurt Vile
Oh, Why	Balam Acab
Then It's White	The Field
How Deep Is Your Love?	The Rapture
MindKilla	Gang Gang Dance
I Don't Want Love	The Antlers
Where I'm Going	Cut Copy
July	Youth Lagoon
Te Amo	Atlas Sound
The Heart Is Willing	A.A. Bondy
Come To The City	The War On Drugs
It's Real	Real Estate
Still Sound	Toro Y Moi
You Can Count On Me	Panda Bear
Hex Girlfriend	Neon Indian
Believer	John Maus
Amor Fati	Washed Out
Midnight City	M83
Oh	FIDLAR
To the Hills	Missing chairs 
We Got A Tan	Dream Love
Put Me To Sleep	Porcelain Raft
Sun Corridor	Norse Horse
So Far Away	A Place To Bury Strangers
The Finest Thing	Grabble And The Final Cut
Shark	Sleeping Bags
Wedding Day	Neverever
Fantastic Explosion Of Time	Pond
Be There	YesYou
Destroyer	Telepathe
Patricia's Thirst	Choir Of Young Believers
Important	Way Yes
One Second Of Love	Nite Jewel
Lineage	Shigeto
My Favorite Girl	Megafortress
Rad Times	Black Bananas
Sun God (Andrew Weatherall Remix)	Cut Copy 
Headcage	Matthew Dear
Now We Continue	White Car
China	Sparkadia
The Great Impression	Sparkadia
Ghost	Sparkadia
Hurt Me	Sparkadia
Fade From View	Sparkadia
Love Less Love	Sparkadia
Still Can't Make Up My Mind	Sparkadia
The Lost Ones	Sparkadia
Talking Like I'm Falling Down Stairs	Sparkadia
I Started Something I Couldn't Finish	Sparkadia
Too Young	Sparkadia
Shoot Straight	Sparkadia
Fingerprints	Sparkadia
Mary	Sparkadia
You Make Me Wanna	Usher
Broken Brights	Angus Stone
Lion	Eugene McGuiness
Things That Make You Go Hmmmm	C+C Music Factory
Coming Out Of The Dark	Gloria Estefan
Winter In July	Bomb The Bass
How Can I Love You More	M People
Cry For Help	Rick Astley
Only You	P-Raise
Twist And Shout	Deacon Blue
When A Man Loves A Woman	Michael Bolton
Happy	Ned's Atomic Dustbin
Let The Beat Hit 'Em	Lisa Lisa & Cult Jam
If You Go Away	New Kids On The Block
Spiritual High	Moodswings Feat. Chrissie Hynde
Promise Me	Beverley Craven
My Side Of The Bed	Susanna Hoffs
Mesmerise	Chapterhouse
Get Ready	Roachford
Carnival 2000	Prefab Sprout
Anthem	N-Joi
Love Thy Will Be Done	Martika
Love Rears It's Ugly Head	Living Colour
Stairway	Yukon Blonde
Paris Collides (Frames Remix)	Rufus
Poison	HTRK
It Feels Good To Be Around You	Air France
Moon Killer	Small Black
Punch Struck	First Preson Shootr
A Walk	Tycho
Coast to Coast	Twerps
Wedding Day	Neverever
Corvalis	Dive
Everywhere, Everyone	Lilacs & Champagne
Know Me	Frankie Rose
Last Night	Beni
You're Mine	Devin
Serpents	Sharon van Etten

